#domain
hospital
#levelname
MATest
#colors
blue: 0, A
green: 1, B
#initial
+++++++++++++++++
+              0+
+    + +        +
+1   + +        +
+   A+ +       B+
+++++++++++++++++
#goal
+++++++++++++++++
+A              +
+    + +        +
+    + +        +
+    + + B      +
+++++++++++++++++
#end
