#domain
hospital
#levelname
SAEasyPeasy
#colors
blue: 0, A, B
#initial
+++++++++++++++++
+A              +
+++++++++++++  0+
+               +
+++++++++++++   +
+               +
+++++++++++++   +
+               +
+++++++++++++   +
+B              +
+++++++++++++++++
#goal
+++++++++++++++++
+               +
+++++++++++++   +
+A              +
+++++++++++++   +
+               +
+++++++++++++   +
+B              +
+++++++++++++   +
+               +
+++++++++++++++++
#end
