#domain
hospital
#levelname
SATest
#colors
blue: 0, B
#initial
+++++++++++++++++
+              0+
+    + +        +
+    + +       B+
+++++++++++++++++
#goal
+++++++++++++++++
+               +
+    + +        +
+    +B+        +
+++++++++++++++++
#end
